#Example: Most of Europe north of med.
mild_winter = {
	# Ireland
	8 10 12
	# Ireland
	3 4 5 7 9 11 13 14 15 16
	# British Isles
	33 35 54 1938 1939 1951 1952 1953 1954 1955 
	# England & Wales
	17 18 19 20 21 22 23 24 25 26 27 28 29 30 31 32 52 53 55 56 57 58 59 60 61 62 63 64 65 66 67 68 69 70 71 72 73 1940 1941 1942 1943 1944 1945 1946 1947 1948 1949 1950 
	# Netherlands
	74 76 77 78 79 90 91 92 93 94 113 115 116 117 118 129 119
	# France
	75 95 96 97 98 99 107 108 109 110 111 112 114 130 131 132 135 136 137 138 139 140 141 142 144 143 145 146 147 149 150 212 213 214 215 216 218 220 222 225 226 227 239 240 148 1608 1609 1956 1958 1959 1960 1961 1962 1963 1964 1965 1966 1611 1614 1615
	# Brittany
	100 101 102 103 104 105 106 1936 1937 1957
	# Italy
	233 234 319 320 321 353 354 355 456 457 461 462 463 929 1707 1708 1711 1712 1713 1714 349
	# Iberia
	173 174 175 176 177 178 181 189 190 196 197 198 199 200 201 202 203 204 1974 1975 1977 1978 
	# Mongol Empire
	621 622 623 628 900 901 902 903 1181 1188 1186 1378 1431 1794 1793 1787 1792 624 625 1791 1788 1789
	# Albania
	561 562 599 600 601 560
	# Hungary
	492 497 498 499 500 501 502 503 504 505 506 507 508 509 510 514 515 516 1642 1643 1644 1645 1973
	# Turkey
	681 702 703 706 707 736 737 749 750 751 759 752 753 760 1934 1933 1930 1931 1932
	# Tarim basin + gobi
	1347 1438 1439 1440 1441 1442 1443 1444 1445 1446 1447 1448 1408 1450 1449 1548 1546 1527 1526 1525 1524 1523 1522 1528 1521 1520 1519 1518 1515 1568 1513 1514 1917 1919
	# Other
	471 493 494 674 668 669 673 676 677 680 679 1013 670 671 672 682 704 667 685 666 686 1187 1185 1189 1182 907 1377 1539 904 1883 1887 1888 1967 1968 1969 1970 1971 
	# Himalayas and Tibet
	1473 1477 1501 1502 1504 1506 1503 1578 1569 1571 1570 1575 1573 2094	2095 2096 2098
	# Atlas Mountains
	847 1778 1776 1775 1780 1733 824 1728

	#Bagan
	2165

	#Xixia
	2437	2438	2439	2440	2441	2442	2443	2444	2446	2447	2448

	#Qin
	2653	2654	2655	2656	2657	2658	2659	2660	2661	2662	2663	2664	2665	2666	2667	2668
	2669	2670	2671	2672	2673	2674	2675	2676	2677

	#Jin
	2455	2456	2457	2458	2678	2679	2680	2681	2682	2683	2684	2685	2686	2687	2688	2689	2690

	#Zhao
	2691	2692	2693	2694	2695	2696	2697	2698	2699	2700	2701	2702	2703	2704	2705	2706	2707

	#Dali
	2423	2424	2425	2426	2427	2428	2429	2430	2431	2432	2433	2434	2435	2436

	#North America
	3620 3627 3628 3629 3630 3631 3632 3634 3635 3636 3637 3638 3640 3681 3684 3688 3695 3696 3697 3698 3706 3707 3708 4128 4129 4229 4232  4267 4282 4351 4353 4354 4355 4361 4375 4376 4379 4383 4384 4392 4426 4468 4718 4719 4720 4721 4722 4723 4724 4765 4766 4774 4785 4796	
              
	#South America
	3925 3928 3931 3934 3935 3936 3949 3955 3956 3963 4531
} 

#Example: Inland Europe & Scandinavia
normal_winter = {
	# Iceland
	1 2 1616 1617
	# British Isles
	34 36
	# Lower Scandinavia
	303 305 6 931 302 301 300
	# Scotland
	37 38 39 40 41 42 43 44 45 46 47 48 49 50 51
	# Denmark
	259 260 261 262 263 264 265 266 267 304 306 307 308 1683 1684 1685 1687
	# East Frisia
	80 81 82 83 84 85 86 87 88 89 120 121 122 254 255 256 257 258 309 310 311 312 313 1987
	# France
	217 219 223 224 242 209 221
	# Germany
	124 125 126 127 128 133 134 245 248 249 250 251 365 366 367 368 369 370 371 372 430 434 435 438 446 447 448 449 930 1587 1588 1589 1688 1689 1690 1691 1692 1693 1694 1695 1696 1697 1698 1699 1700 1979 1980 1981 1982 1983 1984 1985 1986 1986 1988 1989
	# Poland/Lithuania
	373 374 420 421 422 423 424 425 426 427 428 429 431 432 433 440 441 442 443 444 445 451 454 450 520 521 522 523 524 525 
	526 527 528 529 530 531 532 533 534 535 536 537 538 539 540 541 544 545 546 548 549 1581 1582 1583 1584 1585 1586 1590 1591 1592 1593 1594 1595 1596 1597
	1655 1635 1632 1633 1631 1636 1637 1638 1639 1640 1654
	# Pyrenees
	152 151 211
	# Mongolia
	1451 1452 1453 1456 1455 1918 1924 1925 
	# Other
	123 252 253 314 315 360 361 362 363 364 365 437 439 452 453 460 511 512 513 517 518 519 542 543 557 563 596 605 607 618 620 848 1425 1426 1427 1433 1434 897 896 1273 1432 1424 1423 
	604 606 675 603 602 599 597 598 558 559
	1646 1641 1647 1795 1796 1797 1798 1799 1805 1806 1807 1808 1809 1810 1811 1812 1813 1814 1815 1848 1850 1851 1852  1867 1868 1869 1870 1874 1875 1876 1879 1926 1927
	# Himalayas and Tibet
	1161 1179 1180 1351 1505 1508 1494 1495 1489 1500 1498 1496 1497 1499 1492 1493 1507 1491 1476 1490 1487 1485 1486 1488 1468 1467 1465 1470 1471 1480 1483 1484 1564 1572 1558 1554 1553 1550 1555 1559  1556 1557 1567 1579 1552 1561 1566 1551 1562 1562 1563 1565 1547 1543 1544 2097 2104

	#Balhae
	2017	2040

	#Japan
	2850	2851	2852

	#Yan
	2449	2450	2451	2452	2453	2454	2459	2460	2461	2462	2463	2464	2465	2466	2467
	2468

	#North America
	907 3543 3544 3545 3546 3547 3548 3549 3550 3551 3552 3553 3554 3555 3556 3605 3606 3609 3611 3619 3625 3652 3658 3666 3667 3670 3674 3675 3678 3680 3682 3683 3684 3685 3690 4081 4082 4083 4084 4085 4086 4087 4088 4231 4228 4231 4247 4251 4263 4264 4265 4273 4274 4276 4291 4293 4310 4348 4361 4363 4364 4365 4366 4375 4377 4379 4382 4395 4396 4399 4400 4401 4403 4404 4407 4408 4409 4410 4411 4412 4413 4414 4415 4416 4417 4418 4419 4420 4421 4422 4423 4424 4427 4428 4429 4430 4433 4434 4435 4436 4437 4438 4439 4440 4441 4442 4446 4447 4448 4449 4450 4451 4462 4463 4464 4465 4466 44674470 4471 4472 4473 4474 4477 4479 4480 4481 4482 4483 4484 4485 4490 4499 4500 4672 4673 4674 4712 4714 4720 4725 4726 4757 4758 4763 4764 4771 4775 4776 4777 4778 4779 4780 4781 4782 4783 4784 4786 4788 4790 4795 4824 4825 4904

	#South America
	3935 3939 3940 3943 3944 3945 3946 3947 3950 3951 3954 3966 4268

              #NA
	3606 3607 3608 3610 3612 3613 3614 3615 3616 3617 3618 3621 3622 3623 3624 3626 3633 
              3644 3645 3646 3648 3649 3651 3652 3653 3654 3655 3656 3657 3658 3659 3660 3661 3662 3663 3664 3665 3666 3667 3668
              3669 3670 3555 3556 3542 3674 3675 3676 3677 3678 3679 3680 3681 3682 3683 3684 3686 3687 3688 3689 3690 3699 4088 4234 4251 4400 4411 4412 4413 4415 4418 4419 4421 4485 4486 4490 4491 4492 4498 4674 
}

#Example: Russia & Lappland
severe_winter = {
	# Scandinavia
	279 280 386 387 388 389 391 268 269 270 271 272 273 274 275 276 277 278 281 282 283 284 285 286 287 288 289 290 291 292 293 294 295 296 297 298 383 384 385 382 381 390 392 932 376 377 378 379 380 411 413 415
	1599 1600 1601 1602 1603 1604 1605 1606 1607 1620 1621 1622 1623 1624 1625 1701 1702 1703 1704 1705 1706
	# Russia
	393 394 395 396 396 397 398 850 887 888 889 890 892 893 910 1132 1205 1306 1329 399 400 401 402 403 404 405 406 407 408 409 410 412 414 417 551 552 553 554 555 556 564 565 566 567 568 569 570 571 572 573 574 575
	576 577 578 579 580 581 582 583 584 585 586 587 588 589 590 591 592 593 594 595 608 609 610 611 612 613 615 616 617 619 886 891 895 898 933 1223 1430 1435 375 1598 416 419 418 934 550 547 436 1715 1716 1717 1718 1719 1720
	1648 1651 1649 1653 1675 1657 1658 1656 1659 1676 1671 1681 1634 1666 1682 1665 1650 1679 1672 1677 1668 1663 1661 1662 1667 1652 1660 1664 1670 1669 1680 1678 1816 1817 1818 1819 1820 1821 1822 1823 1824 1825 1826 1827 1828 1829 1830 1831 1832 1833 1834 1835 1836 1837 1838 1839 1840 1841 1842 1843 1844 1845
	# Pyrenees
	207 206 210 208 205
	# Alps
	230 229 231 236 232 235 318 317 357 358 455 359 316 247 246 244 238 237 241 228 1610 1613 1709 1710 1612
	# Mongolia
	1454 1463 1462 1459 1461 1458 1457 1460 1895 1896 1897 1516 1517 1898 1899 1900 1901 1902 1903 1904 1905 1906 1907 1908 1909 1910 1911 1912 1913 1914 1915 1916 1920 1921 1922 1923 
	# Himalayas and Tibet
	1464 1466 1469 1472 1474 1475 1478 1479 1481 1482 1511
	# Steppes
	1849 1853 1854 1856 1857 1858 1859 1860 1861 1862 1863 1864 1865 1866 1871 1872 1873 1877 1878

	#Greenland
	2331 2332 3672 3508 3509 3510 3511 3512 3513 3514 3515

	#Mongolia
	2383	2384	2399	2400	2401	2402	2410	2413	2414	2420	2422

	#Khitans
	2470	2471	2472	2473	2474

	#Jurchens
	2055	2056	2019	2020

	#Balhae
	2018	2038	2039	2041	2042	2043	2044	2045	2046	2047	2048	2049	2050	2051	2052
	2053

	#Tibet
	2085
	2204

	#Japan
	2009	2010	2011	2012	2013

	#Canada
	3508 3509 3511 3512 3513 3514 3515 3516 3517 3518 3519 3520 3521 3522 3523 3524 3525 3526 3527 3528 3529 3530
	3531 3532 3533 3534 3535 3536 3537 3538 3539 3540 3541 3650 3647 4077 4078 4476 4477 4479 4480 4495 4496 4497 4503 4504 4505 4506 4507 4508 4509 4510 4511 4524 4529 4532 4537 4549 4543 4553 4554 4556 4557 4558 4559 4561 4562 4563 4564 4566 4567 4568 4569 4570 4571 4573 4574 4575 4576

	#Chile
	4266 4277

	#Yakutia
	3418 3419 3420 3421 3422 3423 3424 3425 3426 3427 3428 3429 3430 3431 3464 3465 3466 3467 3468 3469 3470 3471 3472 3473 3474 3475 3476 3477 4551 4579 4580 4581 4582 4583 4585 4586 4587 4588 4589 4590 4591 4592 4593 4594 4595 4596 4597 4598 4599

}